%%%%%%%%%%%%%%%%%%%
%........%........%
%.%%.%%%.%.%%%.%%.%
%.................%
%.%%.%.%%%%%%.%.%.%
%....%...%...%....%
%%%%.%%%.%.%%%.%%%%
%%%%.%.......%.%%%%
.......%%%%%.......
%%%%.%.......%.%%%%
%%%%.%.%%%%%.%.%%%%
%........%........%
%.%%.%%%.%.%%%.%%.%
%..%...........%..%
%%.%.%.%%%%%.%.%.%%
%....%...%...%....%
%.%%%%%%.%.%%%%%%.%
%.................%
%%%%%%%%%%%%%%%%%%%


